computer: a programmable usually electronic device that can store, retrieve, and process data
unexpurgated: not having potentially offensive or otherwise objectionable parts removed
supernatural: of or relating to an order of existence beyond the visible observable universe; of or relating to God or a god, demigod, spirit, or devil
cactus: any of a family (Cactaceae, the cactus family) of plants that have succulent stems and branches with scales or spines instead of leaves and are found especially in dry areas (such as deserts)
varied: various, diverse
tentacle: any of various elongate flexible usually tactile or prehensile processes borne by animals and especially invertebrates chiefly on the head or about the mouth
crusade: any one of the military expeditions undertaken by Christian powers, in the 11th, 12th, and 13th centuries, for the recovery of the Holy Land from the Mohammedans
realize: to make real; to convert from the imaginary or fictitious into the actual; to bring into concrete existence; to accomplish; as, to realize a scheme or project
compatible: capable of existing together in harmony
sophisticate: to deprive of genuineness, naturalness, or simplicity; to deprive of naivete and make worldly-wise
syncategorematic: forming a meaningful expression only in conjunction with a denotative expression (such as a content word)
panoptic: being or presenting a comprehensive or panoramic view
coefficient: any of the factors of a product considered in relation to a specific factor; a constant factor of a term as distinguished from a variable
revise: an act of revising
unamended: not altered or corrected
change: to undergo transformation, transition, or substitution
denature: to deprive of natural qualities : change the nature of
exchange: the act of giving or taking one thing in return for another
transform: to change in composition or structure
unchanged: not changed; unaltered
consistent: marked by harmony, regularity, or steady continuity, free from variation or contradiction
mutable: prone to change
incursion: a hostile entrance into a territory
intrusion: the act of wrongfully entering upon, seizing, or taking possession of the property of another
entail: to impose, involve, or imply as a necessary accompaniment or result
motivation: the act or process of motivating
mistake: to blunder in the choice of
have: to hold or maintain as a possession, privilege, or entitlement
alternate: occurring or succeeding by turns
revert: to come or go back (as to a former condition, period, or subject)
secret: kept from knowledge or view; hidden
sensitive: receptive to sense impressions
confidential: containing information whose unauthorized disclosure could be prejudicial to the national interest
